############################################################
#^^^//|//^^^^//|//^^^^//|//^^^^//|//^^^<<<<///<<<<^^//|//^^#
#^^/|||||/^^/|||||/^^/|||||/^^/|||||/^^<<*******<<^/|||||/^#
#^^///|///^^///|///^^///|///^^///|///^^<<*******<<^///|///^#
#^^///|///^^///|///^^///|///^^///|///^^<****^****<^///|///^#
#^^///|///^^///|///^^///|///^^///|///^^<***^^^***<^///|///^#
#^^///|///^^///|///^^///|///^^///|///^^<**^^^^^**<^///|///^#
#^^^^^^^^^^^^^^^^^^^^^^^^^^^^^^^^^^^^^^<**^^^^^**<^^^^^^^^^#
#<<<<<<<<<<<<<<<<<<<<<<<<<<<<<<<<<<<<<<<**^^^^^**<<<<<<<<<<#
#**^**^**^**^**^**^**^**^**^**^**^**^**^******************/#
#**^**^**^**^**^**^**^**^**^**^**^**^**^****#****^^^^*****/#
#**^**^**^**^**^**^**^**^**^**^**^**^**^**#^/^#**^^*****|*/#
#**************†***********†***************///***^**||||||/#
#**^**^**^**^**^**^**^**^**^**^**^**^**^***^/^***^^*****|*/#
#**^**^**^**^**^**^**^**^**^**^**^**^**^***^/^***^^^^*****/#
#**^**^**^**^**^**^**^**^**^**^**^**^**^******************/#
#<<<<<<<<<<<<<<<<<<<<<<<<<<<<<<<<<<<<<<<**^^^^^**<<<<<<<<<<#
#^^^^^^^^^^^^^^^^^^^^^^^^^^^^^^^^^^^^^^<**^^^^^**<^^^^^^^^^#
#^^///|///^^///|///^^///|///^^///|///^^<**^^^^^**<^///|///^#
#^^///|///^^///|///^^///|///^^///|///^^<***^^^***<^///|///^#
#^^///|///^^///|///^^///|///^^///|///^^<****^****<^///|///^#
#^^///|///^^///|///^^///|///^^///|///^^<<*******<<^///|///^#
#^^/|||||/^^/|||||/^^/|||||/^^/|||||/^^<<*******<<^/|||||/^#
#^^^//|//^^^^//|//^^^^//|//^^^^//|//^^^<<<<///<<<<^^//|//^^#
############################################################
