############################################################
#^^^^^^^^^^^^^^^^^^^^^^^^^^^^^^^^^^^^^^^^^^^^^^*******^^^^^#
#^^^^^^^^^^^^^^^^^^^^^^^^^***^^^^^^^^^^^^^^^^^*******^^^^^^#
#^^^^^^^^^^^^^^^^^^^^^^^^**o**^^^^^^^^^^^^^^^*******^^^^^^^#
#^^^^^^^^^^^^^^^^^^^^^^^*******^^^^^^^^^^^^********^^^^^^^^#
#^^^^^^^^^^^^^^^^^^^^^^^*******^^^^^^^^^^^******^^^^^^^^^^^#
#^^^^^^^^^^^^^^^^^^^^^^^********^^^^^^^^^******^^^^^^^^^^^^#
#^^^^^^^^^^^^^^^^^^^^^^^^*******^^^^^^^*******^^^^^^^^^^^^^#
#^^^^^^^^^^^^^^^^^^^>>>>>*******^^^^^^******^^^^^^^^^^^^^^^#
#^^^^^^^^^^^^^^>>>>>>>>>>*******^^^^^******^^^^^^^^^^^^^^^^#
#^^^^^^^^^^>>>>>>>>>>>>>>********^^*******^^^^^^^^^^^^^^^^^#
#^^^^^^^>>>>>>>>>>>>>>>>>>*******^******^^^^^^^^^^^^^^^^^^^#
#^^^^^^>>>>>>>>>>>>>>>>^^^*************^^^^^^^^^^^^^^^^^^^^#
#^^^^^>>>>>>>>>>>>>>>^^^^^************^^^^^^^^^^^^^^^^^^^^^#
#^^^^>>>>>>>>>>>>>>>^^^^^^**************^^^^^^^^^^^^^^^^^^^#
#^^^>>>>>>>>>>>>>>>******************************^^^^^^^^^^#
#^^>>>>>>>***********************************************^^#
#**********************************************************#
#********************************^^^^^^^*******************#
#******************^^^^^^^^^******^^^^^^^^^^^^^^^**********#
#*********^^^^^^^^^^^^^^^^^^^*******^^^^^^^^^^^^^^^^^^^****#
#^^^^^^^^^^^^^^^^^^^^^^^^^^^^^*******^^^^^^^^^^^^^^^^^^^^^^#
#^^^^^^^^^^^^^^^^^^^^^^^^^^^^^^^***o**^^^^^^^^^^^^^^^^^^^^^#
#^^^^^^^^^^^^^^^^^^^^^^^^^^^^^^^^******^^^^^^^^^^^^^^^^^^^^#
############################################################
