############################################################
#^^^^^^^^^^^^^^^^^^^^^^^^^^^^^^^^^^^^^^^^^^^^^^^^^^^^^^^^^^#
#^^^^^^^^^^^^^^^^^^^^^^^^^^^^^^^^^^^^^^^^^^^^^^^^^^^^^^^^^^#
#^^^^^^^^^^^^^^^^^^^^^^^^^^^^^^^^^^^^^^^^^^^^^^^^^^^^^^^^^^#
#^^^^^^^^^^^^^^^^^^^^^^^^^^||||||||^^^^^^^^^^^^^^^^^^^^^^^^#
#^^^^^^^^^^^^^^^^^^^^^^^|||********|||^^^^^^^^^^^^^^^^^^^^^#
#^^^^^^^^^^^^^^^^^^^^|||**************|||^^^^^^^^^^^^^^^^^^#
#^^^^^^^^^^^^^^^^^^^|********************|^^^^^^^^^^^^^^^^^#
#^^^^^^^^^^^^^^^^^^|*****^^^^^^^^^^^^*****|^^^^^^^^^^^^^^^^#
#^^^^^^^^^^^^^^^^^|******^|||>>>>|||^******|^^^^^^^^^^^^^^^#
#||||||||||||||||||******^||>>>>>>||^**^^^**|^^^^^^^^^^^^^^#
#************************^|>>>>>>>>|^**^^***|^^^^^^^^^^^^^^#
#************************†>>>>>>>>>>^**^^†**.|^^^^^^^^^^^^^#
#************************^|>>>>>>>>|^**^^***|^^^^^^^^^^^^^^#
#||||||||||||||||||******^||>>>>>>||^**^^^**|^^^^^^^^^^^^^^#
#^^^^^^^^^^^^^^^^^|******^|||>>>>|||^******|^^^^^^^^^^^^^^^#
#^^^^^^^^^^^^^^^^^^|*****^^^^^^^^^^^^*****|^^^^^^^^^^^^^^^^#
#^^^^^^^^^^^^^^^^^^^|********************|^^^^^^^^^^^^^^^^^#
#^^^^^^^^^^^^^^^^^^^^|||**************|||^^^^^^^^^^^^^^^^^^#
#^^^^^^^^^^^^^^^^^^^^^^^|||********|||^^^^^^^^^^^^^^^^^^^^^#
#^^^^^^^^^^^^^^^^^^^^^^^^^^||||||||^^^^^^^^^^^^^^^^^^^^^^^^#
#^^^^^^^^^^^^^^^^^^^^^^^^^^^^^^^^^^^^^^^^^^^^^^^^^^^^^^^^^^#
#^^^^^^^^^^^^^^^^^^^^^^^^^^^^^^^^^^^^^^^^^^^^^^^^^^^^^^^^^^#
#^^^^^^^^^^^^^^^^^^^^^^^^^^^^^^^^^^^^^^^^^^^^^^^^^^^^^^^^^^#
############################################################
