############################################################
#]]]]]]]]]]]]]]]]]]]]]]]]]]]]]]]]]]^^^^^^^^^^^^^^^^^^^^^^^^#
#]]]]]]]]]]]]|||||]]]]]]]]]]]]]]]]]^^^^^^^^^^^^^^^^^^^^^^^^#
#]]]*.*]]]|||^^^^^|||]]]]]]]]]]]]]]]]]^^^^^^^^^^^^^^^^^^^^^#
#]]*****]]|^>>^^^>>^|]]]]]]]]]]]]]]]]]]]]^^^^^****^^^^^^^^^#
#]]]]**]]]|^^^^^^^^^|]]]]]]]]]]]]]]]]]]]]]]^^*****^^^^^^^^^#
#]]]]]**]]|||||/|||||]]]]]]]]]]]]]]**************^^^^^^^^^^#
#]]]]]]**]]]]]]*]]]]]]]]]]]]]*******************^^^^^^^^^^^#
#]]]]]]]********]]]]]]]************]]]]]]]]]]]]]]^^^^^^^^^^#
#]]]]]]]]]]]]]**†************]]]]]]]]]]]]]]]]]]]]]]]^^^^^^^#
#]]]]]]]]]]]]]**]]]]]]]]]]]]]]]]]]]]]]]]]]]]]]]]]]]]]]]^^^^#
#]]]]]]]]]]]]**]]]]]]]]]]]]]]]]]]]]]]]]]]]]]]]]]]]]]]]]]]]]#
#]]]]]]]]]]]**]]]]]]]]]]]]]]]]]]]]]]]]]]]]]]]]]]]]]]]]]]]]]#
#]]]]]]]]]]**]]]]]]]]]]]]]]]]]]]]]]]]]]]]]]]]]]]]]]]]]]]]]]#
#]]]]]]]]]**]]]]]]]]]]]]]]]]]]]]]]]]]]]]]]]]]]]]]]]]]]]]]]]#
#]]]]]]]]**]]]]]]]]]]]]]]]]]]]]]]]]]]]]]]]]]]]]]]]]]]]]]]]]#
#***]]]]**]]]]]]]]]]]]]]]]]]]]]]]]]]]]]]]]]]]]]]]]]]]]]]]]]#
#***********]]]]]]]]]]]]]]]]]]]]]]]*******]]]]]]]]]]]]]]]]]#
#>>>>>>*********]]]]]]]]]]]]*********************]]]]]]]]]]#
#>>>>>>>>>>>>>******************>>>>>>>>>>>>*************]]#
#>>>>>>>>>>>>>>>>>>>>>>>>>>>>>>>>>>>>>>>>>>>>>>>>>>>>******#
#>>>>>>>>>>>>>>>>>>>>>>>>>>>>>>>>>>>>>>>>>>>>>>>>>>>>>>>>>>#
#******>>>>>>>>>>>>>>>>>>>>>>>>>>>>>>>>>>>>>>>>>>>>>>>>>>>>#
#*************>>>>>>>>>>>>>>>>>>************>>>>>>>>>>>>>>>#
############################################################
