############################################################################
#------------------------------------------------|$$$|---------------------#
#------------------------------------------------|$$$|---------------------#
#--------------/---\------------/\---------------|$$$|---------------------#
#--------------|---|------------||---------------|$$$|---------------------#
#--------------|---|------------||---------------|$$$|---------------------#
#--------------|---|----------/-\/-\-------------|$$$|---------------------#
#--------------|---|-----------------------------|$$$|---------------------#
#--------------|---|-----------------------------|$$$|---------------------#
#---------/--\-/---\/--\-------------------------|$$$|---------------------#
#------------------------------------------------|$$$|---------------------#
#------------------------------------------------|$$$\---------------------#
#------------------------------------------------|$$$$\--------------------#
#-------------------------------------------------\$$$$\%%%%%%%%%%%%%%%%%%%#
#--------------------------------------------------\$$$$$$$$$$$$$$$$$$$$$$$#
#---------------------------------------------------%%%%%%%%%%%%%%%%%%%%%%%#
#--------------------------------------------------------------------------#
#---------------------ooooooo----------------------------------------------#
#---------------------o---ooo----------------------------------------------#
#---------------------o*---*o----------------------------------------------#
#------------------------I-------------------------------------------------#
#-----------------------~~~------------------------------------------------#
#----------------------_____-----------------------------------------------#
#--------------------------------------------------------------------------#
#--------------------------------------------------------------------------#
#--------------------------------------------------------------------------#
#--------------------------------------------------------------------------#
#--------------------------------------------------------------------------#
#--------------------------------------------------------------------------#
#--------------------------------------------------------------------------#
############################################################################
