############################################################
#^^^^^^^^^^^^^^^^^^^^^^^^^^^^^^^^^^^^^^^^^^^^^^*******^^^^^#
#^^^^^^^^^^^^^^^^^^^^^^^^^***^^^^^^^^^^^^^^^^^***†***^^^^^^#
#^^^^^^^^^^^^^^^^^^^^^^^^**.**^^^^^^^^^^^^^^^*******^^^^^^^#
#^^^^^^^^^^^^^^^^^^^^^^^***†***^^^^^^^^^^^^********^^^^^^^^#
#^^^^^^^^^^^^^^^^^^^^^^^*******^^^^^^^^^^^******^^^^^^^^^^^#
#^^^^^^^^^^^^^^^^^^^^^^^********^^^^^^^^^******^^^^^^^^^^^^#
#^^^^^^^^^^^^^^^^^^^^^^^^*******^^^^^^^*******^^^^^^^^^^^^^#
#^^^^^^^^^^^^^^^^^^^>>>>>*******^^^^^^******^^^^^^^^^^^^^^^#
#^^^^^^^^^^^^^^>>>>>>>>>>*******^^^^^******^^^^^^^^^^^^^^^^#
#^^^^^^^^^^>>>>>>>>>>>>>>********^^*******^^^^^^^^^^^^^^^^^#
#^^^^^^^>>>>>>>>>>>>>>>>>>*******^******^^^^^^^^^^^^^^^^^^^#
#^^^^^^>>>>>>>>>>>>>>>>^^^*************^^^^^^^^^^^^^^^^^^^^#
#^^^^^>>>>>>>>>>>>>>>^^^^^************^^^^^^^^^^^^^^^^^^^^^#
#^^^^>>>>>>>>>>>>>>>^^^^^^**************^^^^^^^^^^^^^^^^^^^#
#^^^>>>>>>>>>>>>>>>******************************^^^^^^^^^^#
#^^>>>>>>>***********************************************^^#
#*************************************************†********#
#********************************^^^^^^^*******************#
#******************^^^^^^^^^******^^^^^^^^^^^^^^^**********#
#*********^^^^^^^^^^^^^^^^^^^*******^^^^^^^^^^^^^^^^^^^****#
#^^^^^^^^^^^^^^^^^^^^^^^^^^^^^*******^^^^^^^^^^^^^^^^^^^^^^#
#^^^^^^^^^^^^^^^^^^^^^^^^^^^^^^^***.**^^^^^^^^^^^^^^^^^^^^^#
#^^^^^^^^^^^^^^^^^^^^^^^^^^^^^^^^******^^^^^^^^^^^^^^^^^^^^#
############################################################
